111111111111111
10000100D000001
1C0D01000011101
1110010C1000101
10000000000E0P1
111001001000101
1C0001001000101
1000010C1000101
111111111111111
