11111111111111111111
1E0000C00000C00000001
1010010100100000010001
10100100101000000010101
1P0000000C00C000000000C1
1111111111111111111111111
