111111111111111
100000000010001
100000000010E01
100P00000010001
1000000C0011111
100000000000001
111111111111111
